######B#############
###### #############
####   #############
#### ###############
#### ###############
#### ###############
#### ###############
#### ###############
#### #####        ##
#### ##### ###### ##
#### ##    ###### ##
#### ## ######### ##
####    #######   ##
############### ####
############### ####
############### ####
############### ####
#############   ####
############# ######
#############A######